25
25
1111111111111111111111111
1101010101010101010101011
1010101010101010101010101
1101010101010101010101011
1010101010101010101010101
1101010101010101010101011
1010101010101010101010101
1101010101010101010101011
1010101010101010101010101
1101010101010101010101011
1010101010101010101010101
1101010101010101010101011
1010101010101010101010101
1101010101010101010101011
1010101010101010101010101
1101010101010101010101011
1010101010101010101010101
1101010101010101010101011
1010101010101010101010101
1101010101010101010101011
1010101010101010101010101
1101010101010101010101011
1010101010101010101010101
1101010101010101010101011
1111111111111111111111111
